R 640 640
NO ../xpmsprites/wood.XPM
SO ../xpmsprites/redbrick.XPM
WE ../xpmsprites/colorstone.XPM
EA ../xpmsprites/bluestone.XPM

S ../xpmsprites/barrel.XPM
F 220,100,0
C 225,30,0

    1111111111
   1100000001
  1002011111

 1110000101
 100010N001
11111111111
